DEFGAAAACA
JJJJJJJJJJ
JBABABACAJ
JAAIIABAAJ
JAAICBACIA
JBIBBACABJ
JJJJJJJJJJ


