DEFGHAAAAA
JJJJJJJJJJ
JBIBAAACAJ
JBABAABAAJ
JCAAAIBACA
JBAIABICAJ
JJJJJJJJJJ


