DEFGAABABA
JJJJAJJJJJ
JCABIBBCAJ
AAABABBIAJ
JBIBAIBACJ
JBAABIACAJ
JJJJJJJJJJ


