DEFGAAAABA
JJJJJJJJJJ
JCABACACAJ
JAABICBAAJ
JCAAAACACJ
ABIACIBCAJ
JJJAJJJJJJ


